6 12 3
|----------|
|&|.&.$..*.|
|*...|.....|
|&|..@.|...|
|*....|..&$|
|----------|
