8 13
|-----------|
|.F..*...-..|
|...F.-.....|
|...*.-.....|
|..|.@...*..|
|.F....*.F..|
|.*.........|
|-----------|
